12,12,12,12,12,12,12,12,12,12,12,12
12,2,2,2,2,2,2,2,2,2,2,12
12,2,2,2,3,0,3,3,2,3,2,12
12,2,3,3,3,2,2,3,2,3,2,12
12,2,3,2,9,3,3,3,3,3,2,12
12,2,3,2,2,3,3,2,2,2,2,12
12,2,3,2,2,3,6,3,3,5,2,12
12,2,3,2,2,2,2,3,2,3,2,12
12,2,3,3,3,3,3,3,3,5,2,12
12,2,2,6,2,2,6,2,2,1,2,12
12,2,2,2,2,2,2,2,2,2,2,12
12,12,12,12,12,12,12,12,12,12,12,12
