4,4,4,4,4,4,4,4,4,4,4,4
4,0,3,3,3,3,2,2,2,2,2,4
4,9,2,2,2,3,2,2,2,2,2,4
4,9,9,2,2,3,2,2,2,2,2,4
4,2,9,9,9,3,2,2,2,2,2,4
4,2,3,2,9,2,2,2,2,2,2,4
4,2,3,2,9,9,2,2,2,2,2,4
4,2,3,3,2,9,9,9,2,2,2,4
4,2,2,3,3,3,3,9,1,2,2,4
4,2,2,2,2,2,2,2,2,2,2,4
4,2,2,2,2,2,2,2,2,2,2,4
4,4,4,4,4,4,4,4,4,4,4,4
