4,4,4,4,4,4,4,4,4,4,4,4
4,2,2,2,2,2,2,2,2,2,2,4
4,2,0,8,8,8,2,2,2,8,2,4
4,2,8,8,8,8,2,8,8,8,2,4
4,2,8,8,8,8,2,8,8,8,2,4
4,2,8,8,8,2,2,8,8,8,2,4
4,2,8,3,3,8,8,8,8,8,2,4
4,2,8,8,8,8,8,8,8,2,2,4
4,2,8,2,8,8,8,8,8,2,2,4
4,2,8,8,8,2,2,8,8,1,2,4
4,2,2,2,2,2,2,2,2,2,2,4
4,4,4,4,4,4,4,4,4,4,4,4