13,13,13,13,13,13,13,13,13,13,13,13
13,10,10,10,10,10,10,10,10,10,10,13
13,10,0,10,10,10,10,10,10,10,10,13
13,10,8,10,10,10,10,10,10,10,10,13
13,10,8,10,10,10,10,10,10,10,10,13
13,10,8,10,10,10,10,10,10,10,10,13
13,10,8,10,10,10,10,10,10,10,10,13
13,10,8,10,10,10,10,10,10,10,10,13
13,10,8,10,10,10,10,10,10,10,10,13
13,10,3,8,8,8,8,8,8,1,10,13
13,10,10,10,10,10,10,10,10,10,10,13
13,13,13,13,13,13,13,13,13,13,13,13
