4,4,4,4,4,4,4,4,4,4,4,4
4,11,11,11,11,11,11,11,11,11,11,4
4,11,0,11,11,11,11,11,11,11,11,4
4,11,8,11,11,11,11,11,11,11,11,4
4,11,8,11,11,11,11,11,11,11,11,4
4,11,8,11,11,11,11,11,11,11,11,4
4,11,8,11,11,11,11,11,11,11,11,4
4,11,8,11,11,11,11,11,11,11,11,4
4,11,8,11,11,11,11,11,11,11,11,4
4,11,3,8,8,8,8,8,8,1,11,4
4,11,11,11,11,11,11,11,11,11,11,4
4,4,4,4,4,4,4,4,4,4,4,4
