12,12,12,12,12,12,12,12,12,12,12,12
12,2,2,2,2,2,2,2,2,2,2,12
12,2,2,2,2,2,2,2,2,2,2,12
12,2,2,2,2,2,2,2,2,2,2,12
12,2,2,2,2,2,2,2,2,2,2,12
12,2,2,0,5,3,5,3,1,2,2,12
12,2,2,2,2,2,2,2,2,2,2,12
12,2,2,2,2,2,2,2,2,2,2,12
12,2,2,2,2,2,2,2,2,2,2,12
12,2,2,2,2,2,2,2,2,2,2,12
12,2,2,2,2,2,2,2,2,2,2,12
12,12,12,12,12,12,12,12,12,12,12,12
