4,4,4,4,4,4,4,4,4,4,4,4
4,2,2,2,2,2,2,2,2,2,2,4
4,2,0,2,3,2,3,2,3,2,2,4
4,2,3,2,3,3,9,2,3,2,2,4
4,2,3,3,3,2,3,2,3,7,2,4
4,2,2,3,2,3,3,3,3,2,2,4
4,2,2,3,3,7,3,3,2,2,2,4
4,2,2,2,3,2,3,3,2,2,2,4
4,2,3,3,3,2,2,3,3,2,2,4
4,2,2,2,3,3,2,2,3,1,2,4
4,2,2,2,2,2,2,2,2,2,2,4
4,4,4,4,4,4,4,4,4,4,4,4
