14,14,14,14,14,14,14,14,14,14,14,14
14,2,2,2,2,2,2,2,2,2,2,14
14,2,0,2,2,2,2,3,2,2,2,14
14,2,3,3,3,2,2,3,3,3,2,14
14,2,3,2,9,3,3,3,2,3,2,14
14,2,3,3,3,2,7,2,2,3,2,14
14,2,2,2,3,2,3,3,3,3,2,14
14,2,2,7,3,3,3,2,3,2,2,14
14,2,2,2,3,3,3,3,3,2,2,14
14,2,3,3,3,2,2,3,3,1,2,14
14,2,2,2,2,2,2,2,2,2,2,14
14,14,14,14,14,14,14,14,14,14,14,14
