12,12,12,12,12,12,12,12,12,12,12,12
12,2,2,2,2,2,2,2,2,2,2,12
12,2,2,2,2,2,2,2,2,2,2,12
12,2,2,2,2,2,2,2,2,2,2,12
12,2,2,2,2,2,2,2,2,2,2,12
12,2,2,0,5,2,5,2,1,2,2,12
12,2,2,2,2,2,2,2,2,2,2,12
12,2,2,2,2,2,2,2,2,2,2,12
12,2,2,2,2,2,2,2,2,2,2,12
12,2,2,2,2,2,2,2,2,2,2,12
12,2,2,2,2,2,2,2,2,2,2,12
12,12,12,12,12,12,12,12,12,12,12,12
