4,4,4,4,4,4,4,4,4,4,4,4
4,11,11,11,11,11,11,11,11,11,11,4
4,11,0,11,11,11,11,11,11,1,11,4
4,11,3,8,8,11,8,8,8,8,11,4
4,11,8,8,8,11,8,8,8,8,11,4
4,11,8,8,8,11,8,11,11,11,11,4
4,11,11,8,8,8,8,11,3,8,11,4
4,11,8,8,8,8,8,8,8,8,11,4
4,11,8,8,8,11,8,11,3,3,11,4
4,11,3,8,8,11,8,8,8,3,11,4
4,11,11,11,11,11,11,11,11,11,11,4
4,4,4,4,4,4,4,4,4,4,4,4