13,13,13,13,13,13,13,13,13,13,13,13
13,10,10,10,10,10,10,10,10,10,10,13
13,10,0,8,8,8,10,10,10,8,10,13
13,10,8,8,8,8,10,8,8,8,10,13
13,10,8,8,8,8,10,8,8,8,10,13
13,10,8,8,8,10,10,8,8,8,10,13
13,10,8,3,3,8,8,8,8,8,10,13
13,10,8,8,8,8,8,8,8,10,10,13
13,10,8,10,8,8,8,8,8,10,10,13
13,10,8,8,8,10,10,8,8,1,10,13
13,10,10,10,10,10,10,10,10,10,10,13
13,13,13,13,13,13,13,13,13,13,13,13
