14,14,14,14,14,14,14,14,14,14,14,14
14,2,2,2,2,2,2,2,2,2,2,14
14,2,2,2,2,2,2,2,2,2,2,14
14,2,2,2,2,2,2,2,2,2,2,14
14,2,2,0,3,3,3,7,2,2,2,14
14,2,2,2,2,2,2,2,2,2,2,14
14,2,2,2,2,2,2,2,2,2,2,14
14,2,2,7,3,3,3,1,2,2,2,14
14,2,2,2,2,2,2,2,2,2,2,14
14,2,2,2,2,2,2,2,2,2,2,14
14,2,2,2,2,2,2,2,2,2,2,14
14,14,14,14,14,14,14,14,14,14,14,14
