4,4,4,4,4,4,4,4,4,4,4,4
4,2,2,2,2,2,2,2,2,2,2,4
4,2,0,3,2,3,6,3,3,3,2,4
4,2,6,2,2,3,2,2,2,6,2,4
4,2,3,2,3,3,2,3,3,3,2,4
4,2,3,2,2,6,2,2,2,3,2,4
4,2,3,5,3,3,3,3,2,6,2,4
4,2,2,3,2,3,2,3,3,3,2,4
4,2,3,3,2,3,2,3,2,3,2,4
4,2,2,3,2,3,3,3,2,1,2,4
4,2,2,2,2,2,2,2,2,2,2,4
4,4,4,4,4,4,4,4,4,4,4,4
