4,4,4,4,4,4,4,4,4,4,4,4
4,2,2,2,2,2,2,2,2,2,2,4
4,2,0,3,2,2,2,2,2,2,2,4
4,2,3,3,3,3,2,2,2,2,2,4
4,2,3,2,3,3,3,3,2,2,2,4
4,2,3,2,2,2,2,3,3,3,2,4
4,2,3,3,3,3,3,3,3,3,1,4
4,2,2,2,2,2,2,2,2,2,2,4
4,2,2,2,2,2,2,2,2,2,2,4
4,2,2,2,2,2,2,2,2,2,2,4
4,2,2,2,2,2,2,2,2,2,2,4
4,4,4,4,4,4,4,4,4,4,4,4